qqq0000000000000000000000000qqq
qqq0000000000000000000000000qqq
qqq00000000000000w0000000000qqq
qqq000*00000w0000000000000w0qqq
qqq0000000000000000000000000qqq
qqq0000000000000000w00000000qqq
qqq0000000000000000000000000qqq
qqq0000000000000000000000000qqq
qqq0000000000000w00000000000qqq
qqq0000000000000000000000000qqq
qqq0000000000w00000000000000qqq
qqq0000000000000000000000000qqq
qqq00000000w0000000000000000qqq
qqq0000000000000000000000000qqq
qqq0000000w00000000000000000qqq
qqq0000000000000000000000000qqq
qqqg00w000000000000000000000qqq
qqqww00000000000000000000000qqq
qqq0000000000000000000000000qqq

提示：
#锻炼你的跳跃能力
#800
#600

&


